[
[6, 6, 6, 6, 6, 6, 6, 6, 6, 6, 6, 6, 6, 6, 6, 6, 6, 6, 6, 6, 6, 6, 6, 6, 6, 6, 6, 6, 6, 6, 6, 6, 6, 6, 6, 6, 6, 6, 6, 6, 6, 6, 6, 6, 6, 6, 6, 6, 6, 6],
[6, 0, 0, 0, 0, 10, 0, 0, 0, 0, 0, 0, 0, 10, 0, 0, 0, 0, 0, 0, 0, 0, 0, 0, 10, 0, 0, 0, 0, 0, 0, 0, 10, 0, 0, 0, 0, 0, 10, 0, 0, 0, 0, 0, 0, 0, 0, 0, 0, 6],
[6, 0, 0, 0, 11, 10, 11, 0, 0, 0, 0, 0, 11, 10, 11, 0, 0, 0, 0, 0, 0, 0, 0, 11, 10, 11, 0, 0, 0, 0, 0, 11, 10, 11, 0, 0, 0, 11, 10, 11, 0, 0, 0, 0, 0, 0, 0, 0, 0, 6],
[6, 0, 0, 12, 11, 4, 11, 12, 0, 0, 0, 12, 11, 4, 11, 12, 0, 0, 0, 0, 0, 0, 12, 11, 4, 11, 12, 0, 0, 0, 0, 11, 4, 11, 12, 0, 12, 11, 4, 11, 12, 0, 0, 0, 0, 0, 0, 0, 0, 6],
[6, 0, 0, 0, 12, 4, 12, 0, 0, 0, 0, 0, 12, 4, 12, 0, 0, 0, 0, 0, 0, 0, 0, 12, 4, 12, 0, 0, 0, 0, 0, 12, 4, 12, 0, 0, 0, 12, 4, 12, 0, 0, 0, 0, 0, 0, 0, 0, 0, 6],
[6, 0, 0, 0, 0, 4, 0, 0, 0, 0, 0, 0, 0, 4, 0, 0, 0, 0, 0, 0, 0, 0, 0, 0, 4, 0, 0, 0, 0, 0, 0, 0, 4, 0, 0, 0, 0, 0, 4, 0, 0, 0, 0, 0, 0, 0, 0, 0, 0, 6],
[6, 0, 0, 0, 0, 4, 0, 0, 0, 0, 0, 0, 0, 4, 0, 0, 0, 0, 0, 0, 0, 0, 0, 0, 4, 0, 0, 0, 0, 0, 0, 0, 4, 0, 0, 0, 0, 0, 4, 0, 0, 0, 0, 0, 0, 0, 0, 0, 0, 6],
[6, 2, 2, 2, 2, 2, 2, 2, 2, 2, 2, 2, 2, 2, 2, 2, 2, 2, 2, 2, 2, 2, 2, 2, 2, 2, 2, 2, 2, 2, 2, 2, 2, 2, 2, 2, 2, 2, 2, 2, 2, 2, 2, 2, 2, 2, 2, 2, 2, 6],
[6, 3, 3, 3, 3, 3, 5, 5, 5, 3, 3, 3, 3, 3, 3, 3, 3, 3, 3, 3, 3, 3, 3, 3, 3, 3, 3, 3, 3, 3, 3, 3, 3, 3, 3, 3, 3, 3, 5, 8, 9, 13, 13, 9, 8, 5, 3, 3, 3, 6],
[6, 3, 3, 3, 3, 3, 3, 3, 3, 3, 1, 1, 1, 1, 3, 3, 3, 3, 5, 5, 3, 3, 3, 3, 3, 3, 3, 3, 3, 3, 3, 3, 1, 1, 1, 1, 3, 3, 3, 3, 7, 9, 9, 9, 5, 3, 3, 3, 3, 6],
[6, 3, 3, 3, 3, 3, 1, 1, 1, 1, 1, 1, 1, 1, 1, 3, 3, 3, 3, 3, 3, 3, 3, 3, 3, 3, 3, 3, 3, 3, 3, 3, 1, 1, 1, 1, 1, 1, 3, 3, 3, 5, 5, 5, 3, 3, 3, 3, 1, 6],
[6, 5, 3, 3, 3, 1, 1, 1, 1, 1, 1, 1, 1, 1, 1, 3, 3, 3, 3, 3, 3, 3, 3, 3, 3, 3, 3, 3, 3, 3, 3, 3, 3, 1, 1, 1, 1, 1, 1, 3, 3, 3, 3, 5, 5, 3, 3, 3, 3, 6],
[6, 5, 3, 3, 3, 3, 1, 1, 1, 3, 3, 3, 3, 3, 3, 3, 3, 3, 3, 3, 3, 3, 3, 3, 3, 3, 3, 3, 3, 3, 3, 3, 3, 3, 3, 3, 3, 3, 3, 3, 3, 3, 5, 5, 5, 3, 3, 3, 3, 6],
[6, 3, 3, 3, 3, 3, 3, 3, 3, 3, 3, 5, 5, 5, 3, 3, 3, 3, 3, 3, 3, 3, 3, 3, 3, 3, 3, 3, 3, 3, 3, 3, 3, 3, 3, 3, 3, 3, 3, 3, 3, 5, 5, 7, 5, 3, 3, 3, 3, 6],
[6, 3, 3, 3, 3, 3, 3, 3, 3, 5, 7, 9, 9, 9, 9, 7, 7, 5, 7, 8, 9, 9, 9, 7, 5, 5, 3, 3, 3, 3, 3, 5, 5, 5, 7, 5, 5, 5, 5, 5, 5, 7, 7, 5, 5, 3, 3, 3, 3, 6],
[6, 3, 3, 3, 3, 3, 3, 3, 5, 8, 9, 9, 9, 9, 9, 9, 9, 9, 9, 9, 9, 9, 9, 9, 8, 7, 5, 5, 5, 7, 7, 7, 7, 7, 7, 5, 5, 5, 5, 5, 5, 5, 5, 3, 3, 3, 3, 3, 3, 6],
[6, 3, 3, 3, 3, 3, 3, 3, 5, 7, 9, 9, 9, 9, 9, 8, 7, 7, 7, 7, 7, 7, 7, 7, 7, 7, 7, 7, 7, 8, 8, 7, 5, 5, 3, 3, 3, 3, 3, 3, 3, 3, 3, 3, 3, 3, 3, 3, 3, 6],
[6, 3, 3, 3, 3, 3, 3, 3, 3, 3, 5, 5, 7, 5, 5, 5, 3, 3, 3, 3, 3, 3, 3, 3, 3, 3, 5, 5, 5, 5, 5, 5, 3, 3, 3, 3, 3, 3, 3, 3, 3, 3, 3, 3, 3, 3, 3, 3, 3, 6],
[6, 3, 3, 1, 1, 1, 1, 3, 3, 3, 3, 3, 5, 5, 3, 3, 3, 3, 3, 3, 3, 3, 3, 3, 3, 3, 3, 3, 3, 3, 3, 3, 3, 3, 3, 3, 3, 3, 3, 3, 3, 3, 3, 3, 3, 3, 3, 3, 3, 6],
[6, 1, 1, 1, 1, 1, 1, 3, 3, 3, 3, 3, 3, 3, 3, 3, 3, 3, 3, 3, 3, 3, 3, 3, 3, 3, 3, 3, 3, 3, 3, 3, 3, 3, 3, 3, 3, 3, 5, 5, 5, 5, 5, 5, 3, 3, 3, 3, 3, 6],
[6, 3, 1, 1, 1, 1, 3, 3, 3, 3, 3, 3, 3, 3, 3, 3, 3, 3, 3, 3, 3, 3, 3, 3, 3, 3, 3, 3, 3, 3, 3, 3, 3, 3, 3, 3, 3, 3, 5, 5, 5, 3, 3, 3, 3, 3, 3, 3, 3, 6],
[6, 3, 3, 3, 3, 3, 3, 3, 3, 3, 3, 3, 3, 3, 3, 3, 3, 3, 3, 3, 3, 3, 3, 3, 3, 3, 3, 3, 3, 3, 3, 3, 3, 3, 3, 3, 3, 3, 3, 3, 3, 3, 3, 3, 3, 3, 3, 3, 3, 6],
[6, 3, 3, 3, 3, 3, 3, 3, 3, 3, 3, 3, 3, 3, 3, 3, 3, 3, 3, 3, 3, 3, 3, 3, 3, 3, 3, 3, 3, 3, 3, 3, 3, 3, 3, 3, 3, 3, 3, 3, 3, 3, 3, 3, 3, 3, 3, 3, 3, 6],
[6, 3, 3, 3, 3, 3, 3, 3, 3, 3, 3, 3, 3, 3, 3, 3, 3, 3, 3, 3, 3, 3, 5, 5, 3, 3, 3, 3, 3, 3, 3, 3, 3, 3, 3, 3, 3, 3, 3, 5, 5, 3, 3, 3, 3, 3, 3, 3, 5, 6],
[6, 3, 1, 1, 1, 3, 3, 3, 3, 3, 3, 3, 3, 3, 3, 3, 3, 5, 5, 5, 7, 7, 5, 5, 3, 3, 3, 3, 3, 3, 3, 3, 3, 3, 3, 3, 3, 5, 7, 7, 8, 7, 5, 5, 3, 3, 5, 7, 9, 6],
[6, 3, 3, 3, 3, 3, 3, 3, 3, 3, 3, 3, 3, 3, 5, 8, 9, 9, 9, 9, 9, 7, 5, 3, 3, 3, 1, 1, 1, 1, 1, 3, 3, 3, 3, 5, 7, 9, 9, 9, 9, 8, 5, 3, 3, 3, 3, 5, 5, 6],
[6, 3, 3, 3, 5, 7, 8, 7, 5, 5, 3, 3, 3, 5, 7, 9, 9, 9, 9, 9, 7, 3, 3, 3, 1, 1, 1, 1, 1, 1, 1, 3, 3, 3, 5, 8, 9, 9, 9, 9, 9, 5, 3, 3, 3, 3, 3, 3, 3, 6],
[6, 3, 5, 9, 9, 9, 9, 9, 7, 5, 3, 3, 3, 3, 5, 9, 9, 9, 7, 5, 3, 3, 1, 1, 1, 1, 1, 1, 3, 3, 3, 3, 3, 3, 5, 5, 5, 7, 7, 7, 5, 3, 3, 3, 3, 3, 3, 3, 3, 6],
[6, 3, 5, 9, 9, 9, 9, 9, 5, 3, 3, 3, 3, 3, 3, 5, 5, 5, 3, 3, 3, 1, 1, 1, 1, 3, 3, 3, 3, 3, 3, 3, 3, 3, 3, 3, 3, 3, 3, 3, 3, 3, 3, 3, 3, 3, 3, 3, 3, 6],
[6, 3, 3, 5, 8, 8, 7, 5, 3, 3, 3, 1, 1, 3, 3, 3, 3, 3, 3, 3, 1, 1, 1, 1, 3, 3, 5, 7, 7, 8, 7, 5, 5, 3, 3, 3, 3, 3, 3, 3, 3, 3, 3, 5, 5, 5, 5, 7, 5, 6],
[6, 3, 3, 3, 3, 3, 3, 3, 3, 3, 1, 1, 1, 1, 1, 3, 3, 1, 1, 1, 1, 1, 1, 3, 3, 5, 8, 9, 9, 9, 8, 7, 5, 3, 3, 3, 3, 3, 3, 3, 3, 5, 7, 9, 9, 9, 9, 7, 5, 6],
[6, 1, 1, 3, 3, 3, 3, 3, 3, 3, 3, 3, 3, 3, 3, 1, 1, 1, 1, 1, 1, 1, 3, 3, 3, 5, 7, 7, 5, 5, 3, 3, 3, 3, 3, 3, 5, 5, 5, 7, 9, 9, 9, 9, 9, 9, 7, 5, 3, 6],
[6, 3, 3, 3, 3, 3, 3, 3, 3, 3, 3, 3, 3, 3, 3, 3, 3, 3, 3, 3, 3, 3, 3, 3, 5, 5, 5, 3, 3, 3, 3, 3, 3, 3, 3, 5, 5, 5, 7, 8, 9, 9, 9, 9, 9, 5, 3, 3, 3, 6],
[6, 3, 3, 3, 3, 3, 3, 3, 3, 3, 3, 3, 5, 5, 3, 3, 3, 3, 3, 3, 3, 3, 5, 7, 7, 7, 5, 3, 3, 3, 3, 3, 3, 3, 3, 3, 3, 3, 3, 3, 7, 9, 9, 9, 8, 5, 3, 3, 3, 6],
[6, 7, 5, 5, 3, 3, 3, 3, 3, 5, 5, 5, 7, 7, 7, 5, 5, 5, 5, 5, 7, 8, 9, 9, 9, 8, 5, 3, 3, 3, 3, 1, 1, 1, 1, 1, 3, 3, 3, 3, 3, 5, 7, 8, 7, 5, 3, 3, 3, 6],
[6, 8, 7, 7, 8, 8, 9, 9, 9, 9, 9, 8, 7, 5, 5, 5, 5, 5, 5, 7, 8, 9, 9, 9, 9, 9, 8, 5, 3, 3, 3, 1, 1, 1, 1, 1, 1, 1, 1, 3, 3, 3, 3, 3, 3, 3, 3, 3, 3, 6],
[6, 5, 5, 7, 9, 9, 9, 9, 9, 9, 9, 5, 3, 3, 3, 3, 3, 3, 3, 5, 7, 9, 9, 13, 13, 9, 9, 5, 3, 3, 3, 1, 1, 1, 1, 1, 1, 1, 3, 3, 3, 3, 3, 3, 3, 3, 3, 3, 3, 6],
[6, 3, 3, 3, 5, 9, 9, 9, 9, 7, 3, 3, 3, 1, 1, 1, 3, 3, 3, 3, 5, 8, 9, 13, 13, 9, 9, 5, 3, 3, 1, 1, 1, 1, 1, 1, 3, 3, 3, 3, 3, 3, 3, 3, 3, 3, 3, 3, 3, 6],
[6, 3, 3, 3, 5, 5, 7, 7, 5, 3, 3, 3, 1, 1, 1, 1, 3, 3, 3, 3, 5, 9, 9, 13, 13, 9, 7, 3, 3, 3, 1, 1, 1, 1, 1, 3, 3, 3, 3, 5, 5, 3, 3, 3, 3, 3, 3, 3, 5, 6],
[6, 3, 3, 3, 3, 3, 3, 3, 3, 3, 1, 1, 1, 1, 1, 1, 3, 3, 3, 5, 7, 9, 9, 13, 9, 9, 5, 3, 3, 1, 1, 1, 1, 1, 1, 3, 3, 3, 5, 5, 5, 3, 3, 3, 3, 3, 3, 3, 5, 6],
[6, 3, 3, 3, 3, 3, 3, 3, 1, 1, 1, 1, 0, 0, 1, 1, 3, 3, 5, 5, 9, 9, 9, 9, 9, 5, 3, 3, 1, 1, 1, 1, 1, 1, 3, 3, 3, 3, 3, 3, 3, 3, 3, 3, 3, 3, 3, 3, 3, 6],
[6, 3, 3, 3, 5, 3, 3, 3, 1, 1, 1, 1, 0, 0, 1, 1, 3, 3, 3, 5, 7, 9, 9, 9, 8, 5, 3, 3, 1, 1, 1, 1, 1, 3, 3, 3, 3, 3, 3, 3, 1, 1, 1, 1, 1, 1, 3, 3, 3, 6],
[6, 3, 5, 7, 8, 8, 5, 3, 3, 3, 1, 1, 1, 1, 1, 1, 3, 3, 3, 3, 5, 8, 9, 9, 9, 7, 3, 3, 3, 1, 1, 1, 3, 3, 3, 3, 3, 3, 3, 1, 1, 1, 1, 1, 1, 3, 3, 3, 3, 6],
[6, 3, 5, 9, 9, 9, 9, 9, 5, 3, 3, 3, 1, 1, 1, 1, 3, 3, 3, 3, 5, 7, 9, 9, 9, 9, 7, 3, 3, 3, 3, 3, 3, 3, 5, 5, 3, 3, 3, 1, 1, 1, 1, 1, 3, 3, 3, 3, 5, 6],
[6, 5, 7, 9, 13, 15, 13, 9, 9, 5, 3, 3, 3, 3, 1, 3, 3, 3, 3, 3, 3, 7, 9, 13, 13, 13, 9, 8, 5, 3, 3, 3, 3, 5, 7, 7, 5, 3, 3, 3, 1, 1, 1, 3, 3, 3, 5, 7, 7, 6],
[6, 3, 5, 9, 9, 9, 9, 9, 9, 7, 5, 3, 3, 3, 3, 3, 3, 3, 3, 3, 3, 5, 7, 9, 9, 9, 9, 9, 7, 5, 5, 5, 7, 7, 9, 9, 8, 7, 5, 3, 3, 3, 3, 3, 3, 3, 3, 3, 3, 6],
[6, 3, 3, 5, 7, 7, 5, 5, 5, 5, 5, 5, 5, 3, 3, 3, 3, 3, 3, 3, 3, 3, 3, 3, 3, 3, 5, 5, 5, 7, 7, 7, 7, 5, 5, 5, 7, 7, 9, 9, 9, 7, 5, 3, 3, 3, 3, 3, 3, 6],
[6, 3, 5, 5, 5, 3, 3, 3, 3, 3, 3, 5, 5, 5, 5, 3, 3, 3, 3, 3, 3, 3, 3, 3, 3, 3, 3, 3, 3, 5, 5, 5, 3, 3, 3, 3, 3, 5, 7, 9, 9, 9, 9, 7, 3, 3, 3, 3, 3, 6],
[6, 5, 7, 7, 5, 3, 3, 3, 3, 3, 3, 5, 5, 7, 5, 5, 3, 3, 3, 3, 3, 3, 3, 3, 1, 3, 3, 3, 3, 5, 5, 5, 3, 3, 3, 3, 3, 3, 5, 9, 9, 9, 9, 9, 7, 3, 3, 3, 3, 6],
[6, 9, 9, 9, 9, 5, 3, 3, 3, 3, 5, 7, 7, 7, 7, 5, 3, 3, 3, 3, 3, 3, 3, 3, 3, 3, 3, 3, 3, 3, 5, 3, 3, 3, 3, 3, 3, 3, 3, 5, 9, 9, 13, 9, 9, 7, 5, 3, 3, 6],
[6, 13, 15, 15, 9, 9, 5, 3, 3, 5, 8, 9, 9, 9, 7, 3, 3, 3, 3, 3, 3, 3, 3, 3, 3, 3, 3, 3, 3, 3, 3, 3, 3, 1, 1, 1, 1, 3, 3, 3, 7, 9, 9, 9, 7, 5, 3, 3, 3, 6],
[6, 13, 15, 15, 9, 9, 5, 5, 5, 7, 9, 9, 9, 8, 5, 3, 3, 3, 3, 3, 5, 5, 5, 3, 3, 3, 3, 3, 3, 3, 3, 1, 1, 1, 1, 1, 3, 3, 3, 3, 5, 5, 5, 5, 3, 3, 3, 3, 3, 6],
[6, 9, 9, 9, 9, 5, 3, 3, 3, 5, 7, 9, 8, 5, 3, 3, 3, 3, 3, 3, 5, 8, 9, 9, 5, 3, 3, 3, 3, 3, 1, 1, 1, 1, 1, 3, 3, 3, 3, 5, 5, 5, 5, 3, 3, 3, 3, 3, 3, 6],
[6, 5, 5, 5, 3, 3, 3, 3, 3, 3, 3, 5, 5, 3, 3, 3, 3, 3, 3, 3, 7, 9, 9, 9, 9, 7, 5, 3, 3, 3, 3, 3, 1, 1, 3, 3, 3, 3, 5, 5, 7, 8, 7, 5, 3, 3, 3, 3, 3, 6],
[6, 3, 3, 3, 3, 3, 1, 1, 1, 3, 3, 3, 3, 3, 3, 3, 3, 3, 3, 5, 7, 9, 9, 13, 9, 9, 8, 5, 5, 3, 3, 3, 3, 3, 3, 3, 3, 3, 5, 8, 9, 9, 9, 9, 9, 9, 8, 7, 5, 6],
[6, 3, 3, 3, 3, 1, 1, 1, 1, 1, 1, 3, 3, 3, 3, 3, 3, 3, 3, 5, 8, 9, 9, 9, 9, 9, 9, 9, 9, 9, 9, 7, 7, 5, 5, 5, 5, 5, 7, 9, 9, 9, 15, 15, 15, 15, 13, 9, 9, 6],
[6, 5, 3, 3, 3, 1, 1, 1, 1, 1, 1, 1, 1, 3, 3, 3, 3, 3, 5, 5, 7, 7, 7, 7, 7, 7, 7, 9, 9, 9, 9, 13, 13, 9, 9, 9, 7, 5, 5, 5, 7, 9, 9, 15, 15, 15, 9, 9, 7, 6],
[6, 3, 3, 3, 3, 3, 3, 3, 3, 3, 3, 3, 3, 3, 3, 3, 3, 3, 3, 3, 3, 3, 3, 3, 3, 3, 3, 3, 5, 9, 9, 15, 15, 15, 9, 9, 7, 3, 3, 3, 3, 5, 7, 9, 9, 9, 7, 3, 3, 6],
[6, 3, 3, 3, 3, 3, 3, 3, 3, 3, 3, 3, 3, 3, 3, 3, 3, 3, 3, 3, 3, 3, 3, 3, 3, 3, 3, 3, 3, 5, 9, 9, 13, 13, 9, 7, 3, 3, 3, 3, 3, 3, 3, 5, 5, 3, 3, 3, 3, 6],
[6, 1, 1, 1, 1, 3, 3, 3, 5, 5, 5, 3, 3, 3, 3, 3, 3, 3, 3, 3, 3, 3, 3, 1, 1, 1, 1, 3, 3, 3, 5, 8, 9, 9, 8, 5, 3, 3, 3, 3, 3, 3, 3, 3, 3, 3, 3, 1, 1, 6],
[6, 1, 1, 1, 1, 1, 3, 3, 3, 3, 3, 3, 3, 3, 3, 3, 3, 3, 3, 3, 3, 3, 1, 1, 1, 1, 1, 1, 1, 3, 3, 3, 5, 5, 5, 3, 3, 3, 3, 1, 1, 1, 1, 3, 1, 1, 1, 1, 1, 6],
[6, 1, 1, 1, 1, 1, 3, 3, 3, 3, 3, 3, 3, 3, 3, 3, 3, 3, 3, 3, 3, 3, 3, 3, 1, 1, 1, 1, 1, 1, 3, 3, 3, 5, 5, 3, 3, 3, 3, 3, 3, 3, 3, 3, 1, 1, 1, 1, 0, 6],
[6, 3, 3, 3, 3, 3, 3, 3, 3, 3, 3, 3, 3, 3, 3, 3, 3, 3, 3, 3, 3, 3, 3, 3, 3, 3, 3, 3, 3, 3, 3, 3, 3, 5, 5, 5, 3, 3, 3, 3, 3, 3, 3, 3, 3, 3, 1, 1, 1, 6],
[6, 3, 5, 5, 5, 3, 3, 3, 3, 3, 3, 3, 3, 3, 3, 3, 3, 3, 3, 3, 3, 3, 3, 3, 3, 3, 3, 3, 3, 3, 3, 3, 5, 7, 7, 5, 3, 3, 3, 3, 3, 3, 5, 5, 5, 5, 3, 3, 1, 6],
[6, 7, 9, 9, 9, 9, 7, 7, 5, 7, 8, 9, 9, 8, 7, 5, 5, 3, 3, 3, 3, 5, 5, 5, 5, 7, 5, 5, 5, 5, 5, 5, 7, 7, 5, 5, 3, 3, 3, 3, 3, 3, 7, 9, 9, 9, 7, 3, 3, 6],
[6, 9, 9, 9, 9, 9, 9, 9, 9, 9, 9, 9, 9, 9, 9, 7, 7, 5, 5, 5, 7, 7, 7, 7, 7, 7, 5, 5, 5, 5, 5, 5, 5, 5, 3, 3, 3, 3, 3, 3, 3, 3, 5, 7, 9, 8, 5, 3, 3, 6],
[6, 9, 9, 9, 9, 9, 8, 7, 5, 7, 7, 7, 7, 7, 7, 7, 7, 7, 7, 7, 8, 8, 7, 5, 5, 3, 3, 3, 3, 3, 3, 3, 3, 3, 3, 3, 3, 3, 3, 3, 3, 3, 3, 3, 3, 3, 3, 3, 3, 6],
[6, 5, 5, 7, 5, 5, 3, 3, 3, 3, 3, 3, 3, 3, 3, 3, 3, 5, 5, 5, 5, 5, 5, 3, 3, 3, 3, 3, 3, 3, 3, 3, 3, 3, 3, 3, 3, 3, 3, 3, 3, 3, 3, 3, 3, 3, 3, 3, 3, 6],
[6, 3, 3, 5, 5, 3, 3, 3, 3, 3, 3, 3, 3, 3, 3, 3, 3, 3, 3, 3, 3, 3, 3, 3, 3, 3, 3, 3, 3, 3, 3, 3, 3, 3, 3, 3, 3, 3, 3, 3, 3, 3, 3, 3, 3, 3, 3, 3, 3, 6],
[6, 3, 3, 3, 3, 3, 3, 3, 3, 3, 3, 3, 3, 3, 3, 3, 3, 3, 3, 3, 3, 3, 3, 3, 3, 3, 3, 3, 3, 5, 5, 5, 5, 5, 3, 3, 3, 3, 3, 3, 3, 3, 5, 5, 5, 5, 5, 3, 3, 6],
[6, 3, 3, 3, 3, 3, 3, 3, 3, 3, 3, 3, 3, 3, 3, 3, 3, 3, 3, 3, 3, 3, 3, 3, 3, 3, 3, 3, 3, 5, 5, 5, 3, 3, 3, 3, 3, 3, 3, 3, 3, 5, 5, 5, 5, 5, 3, 3, 3, 6],
[6, 3, 3, 3, 3, 3, 3, 3, 3, 3, 3, 3, 3, 3, 3, 3, 3, 3, 3, 3, 3, 3, 3, 3, 3, 3, 3, 3, 3, 3, 3, 3, 3, 3, 3, 3, 3, 3, 3, 3, 3, 5, 5, 5, 5, 3, 3, 3, 3, 6],
[6, 3, 3, 3, 3, 3, 3, 3, 3, 3, 3, 3, 3, 3, 3, 3, 3, 3, 3, 3, 3, 3, 3, 3, 3, 3, 3, 3, 3, 3, 3, 3, 3, 3, 3, 3, 3, 3, 3, 3, 5, 7, 8, 7, 5, 3, 3, 3, 1, 6],
[6, 3, 3, 3, 3, 3, 3, 3, 3, 3, 3, 3, 3, 5, 5, 3, 3, 3, 3, 3, 3, 3, 3, 3, 3, 3, 3, 3, 3, 5, 5, 5, 3, 3, 3, 3, 3, 3, 3, 5, 9, 9, 9, 9, 7, 5, 3, 3, 1, 6],
[6, 3, 3, 3, 3, 3, 3, 5, 5, 5, 7, 7, 7, 5, 5, 3, 3, 3, 3, 3, 3, 3, 3, 3, 3, 3, 3, 3, 5, 7, 8, 7, 7, 5, 5, 3, 5, 5, 7, 9, 9, 13, 13, 9, 9, 7, 3, 3, 3, 6],
[6, 3, 3, 3, 3, 5, 8, 9, 9, 9, 9, 9, 7, 3, 3, 3, 3, 1, 1, 1, 1, 1, 3, 3, 3, 3, 5, 8, 9, 9, 9, 9, 8, 5, 3, 3, 3, 3, 5, 7, 8, 9, 9, 7, 5, 5, 3, 3, 3, 6],
[6, 3, 3, 3, 5, 8, 9, 9, 9, 9, 9, 5, 3, 3, 1, 1, 1, 1, 1, 1, 1, 1, 3, 3, 3, 5, 8, 9, 9, 9, 9, 9, 5, 3, 3, 3, 3, 3, 3, 3, 3, 3, 3, 3, 3, 3, 3, 3, 3, 6],
[6, 3, 3, 3, 3, 7, 9, 9, 9, 7, 3, 3, 3, 1, 1, 1, 1, 1, 3, 3, 3, 3, 3, 3, 3, 5, 5, 7, 7, 7, 7, 5, 3, 3, 3, 3, 3, 3, 3, 3, 3, 3, 1, 1, 3, 3, 3, 3, 5, 6],
[6, 3, 3, 3, 3, 3, 5, 5, 5, 3, 3, 3, 1, 1, 1, 1, 3, 3, 3, 3, 3, 3, 3, 3, 3, 3, 3, 3, 3, 3, 3, 3, 3, 3, 3, 3, 3, 3, 3, 3, 3, 3, 3, 3, 3, 3, 3, 5, 7, 6],
[6, 3, 1, 3, 3, 3, 3, 3, 3, 3, 1, 1, 1, 1, 1, 3, 3, 5, 7, 7, 8, 7, 5, 3, 3, 3, 3, 3, 3, 3, 3, 3, 3, 3, 5, 5, 5, 7, 7, 5, 3, 3, 3, 3, 3, 3, 3, 5, 7, 6],
[6, 1, 1, 1, 1, 3, 3, 3, 1, 1, 1, 1, 1, 1, 3, 3, 5, 9, 9, 9, 9, 8, 5, 3, 3, 3, 3, 3, 3, 3, 3, 5, 5, 8, 9, 9, 9, 9, 7, 5, 3, 3, 3, 3, 3, 3, 3, 5, 5, 6],
[6, 3, 3, 3, 3, 3, 1, 1, 1, 1, 1, 1, 1, 3, 3, 3, 7, 7, 7, 5, 5, 3, 3, 3, 3, 3, 5, 5, 5, 5, 7, 9, 9, 9, 9, 9, 8, 5, 3, 3, 3, 3, 3, 3, 3, 3, 3, 3, 3, 6],
[6, 3, 3, 3, 3, 3, 3, 3, 3, 3, 3, 3, 3, 3, 5, 5, 5, 5, 3, 3, 3, 3, 3, 3, 3, 3, 5, 5, 5, 7, 9, 9, 9, 9, 9, 9, 5, 3, 3, 3, 3, 3, 3, 3, 3, 3, 3, 3, 3, 6],
[6, 3, 3, 5, 5, 3, 3, 3, 3, 3, 3, 3, 5, 5, 7, 7, 5, 5, 3, 3, 3, 3, 3, 3, 3, 3, 3, 3, 3, 3, 5, 7, 9, 9, 9, 7, 5, 3, 3, 3, 3, 3, 3, 3, 3, 3, 3, 3, 3, 6],
[6, 5, 7, 7, 7, 7, 5, 5, 5, 5, 5, 7, 9, 9, 9, 9, 8, 5, 3, 3, 3, 3, 1, 1, 1, 1, 1, 3, 3, 3, 3, 3, 5, 7, 7, 5, 3, 3, 3, 3, 3, 3, 3, 5, 5, 5, 3, 3, 3, 6],
[6, 9, 8, 7, 5, 5, 5, 5, 5, 5, 7, 9, 9, 9, 9, 9, 9, 7, 5, 3, 3, 3, 1, 1, 1, 1, 1, 1, 1, 1, 3, 3, 3, 3, 3, 3, 3, 3, 3, 3, 3, 3, 5, 8, 9, 9, 7, 5, 3, 6],
[6, 8, 5, 3, 3, 3, 3, 3, 3, 3, 5, 7, 9, 9, 13, 13, 9, 9, 5, 3, 3, 1, 1, 1, 1, 1, 1, 1, 1, 3, 3, 3, 3, 3, 3, 3, 3, 3, 3, 3, 3, 7, 9, 9, 9, 9, 8, 5, 5, 6],
[6, 3, 3, 3, 1, 1, 1, 3, 3, 3, 3, 5, 9, 9, 13, 13, 9, 7, 5, 3, 3, 1, 1, 1, 1, 1, 1, 3, 3, 3, 3, 3, 3, 3, 3, 3, 3, 3, 3, 5, 7, 9, 9, 9, 8, 7, 5, 3, 3, 6],
[6, 3, 1, 1, 1, 1, 1, 3, 3, 3, 3, 5, 9, 9, 13, 9, 9, 7, 3, 3, 3, 1, 1, 1, 1, 1, 3, 3, 3, 5, 5, 5, 3, 3, 3, 3, 3, 3, 3, 5, 7, 9, 9, 7, 5, 3, 3, 3, 3, 6],
[6, 1, 1, 1, 1, 1, 1, 3, 3, 3, 5, 8, 9, 13, 13, 9, 8, 5, 3, 3, 1, 1, 1, 1, 1, 3, 3, 3, 3, 5, 5, 5, 3, 3, 3, 3, 3, 3, 3, 5, 7, 7, 5, 5, 3, 3, 3, 3, 3, 6],
[6, 1, 0, 0, 0, 1, 1, 3, 3, 5, 7, 9, 9, 9, 9, 9, 5, 3, 3, 1, 1, 1, 1, 1, 1, 3, 3, 3, 3, 3, 3, 3, 3, 3, 3, 3, 3, 3, 3, 3, 3, 3, 3, 3, 3, 3, 3, 3, 3, 6],
[6, 1, 1, 0, 1, 1, 1, 3, 3, 5, 5, 8, 9, 9, 9, 7, 3, 3, 3, 1, 1, 1, 1, 1, 3, 3, 3, 3, 3, 3, 3, 1, 1, 1, 1, 1, 3, 3, 3, 3, 3, 3, 3, 3, 3, 3, 3, 3, 5, 6],
[6, 1, 1, 1, 1, 1, 1, 3, 3, 3, 3, 5, 9, 9, 9, 9, 5, 3, 3, 1, 1, 1, 1, 3, 3, 3, 3, 3, 3, 3, 1, 1, 1, 1, 1, 1, 3, 3, 3, 3, 3, 3, 3, 3, 3, 3, 3, 5, 9, 6],
[6, 3, 3, 1, 1, 1, 1, 3, 3, 3, 3, 5, 9, 9, 9, 9, 9, 7, 3, 3, 3, 3, 3, 3, 3, 5, 5, 3, 3, 3, 1, 1, 1, 1, 1, 3, 3, 3, 5, 5, 3, 3, 3, 3, 3, 3, 3, 5, 9, 6],
[6, 3, 3, 3, 3, 1, 3, 3, 3, 3, 3, 5, 7, 9, 13, 13, 13, 9, 7, 5, 3, 3, 3, 5, 7, 7, 7, 5, 3, 3, 3, 1, 1, 1, 3, 3, 3, 5, 7, 7, 5, 3, 3, 3, 3, 3, 3, 3, 8, 6],
[6, 5, 3, 3, 3, 3, 3, 3, 3, 3, 3, 3, 5, 7, 9, 9, 9, 9, 9, 7, 5, 5, 5, 7, 8, 9, 9, 7, 7, 5, 3, 3, 3, 3, 3, 3, 3, 3, 3, 3, 3, 3, 3, 3, 3, 3, 3, 3, 5, 6],
[6, 5, 5, 5, 3, 3, 3, 3, 3, 3, 3, 3, 3, 3, 3, 3, 3, 5, 5, 5, 7, 7, 7, 5, 5, 5, 5, 7, 7, 9, 9, 8, 7, 5, 3, 3, 3, 3, 3, 3, 3, 3, 3, 5, 5, 5, 5, 3, 3, 6],
[6, 3, 5, 5, 5, 5, 3, 3, 3, 3, 3, 3, 3, 3, 3, 3, 3, 3, 3, 3, 5, 5, 5, 3, 3, 3, 3, 3, 5, 8, 9, 9, 9, 9, 5, 3, 3, 3, 3, 3, 3, 3, 5, 7, 8, 7, 5, 3, 3, 6],
[6, 3, 5, 7, 7, 5, 3, 3, 3, 3, 3, 3, 3, 3, 3, 1, 3, 3, 3, 3, 5, 5, 3, 3, 3, 3, 3, 3, 3, 5, 9, 9, 9, 9, 9, 5, 3, 3, 3, 3, 3, 3, 5, 7, 7, 5, 3, 3, 1, 6],
[6, 6, 6, 6, 6, 6, 6, 6, 6, 6, 6, 6, 6, 6, 6, 6, 6, 6, 6, 6, 6, 6, 6, 6, 6, 6, 6, 6, 6, 6, 6, 6, 6, 6, 6, 6, 6, 6, 6, 6, 6, 6, 6, 6, 6, 6, 6, 6, 6, 1]
]